intro: You must reach the core of the planet and plant the bomb.
intro: Destroy the local population and collect anything valuable!
intro: Unfortunately, stone will be a problem due to your equipment.
0000000000000000000000000
0000000000000000000000000
0000000000000000000000000
0000000000000000000000000
44P0004400044400004044040
1111111111111111111111111
2223222322232223222322232
3322222222222222222222222
2222222222222222222222222
2222222222222222222222222
3333332233333333333333333
2222223222222222222222222
2222222222222222222222222
2222222222222222222222222
2222222222222222222222222
22222222222222222R2222222
2222222222222222222222222
2222222222222222222222222
3333232323233323332323233
