intro: We have detected bombs underground...
intro: We have no idea why these are there, but use them!
0000000000000000000000000
0000000000000000000000000
0000000000000000000000000
0000000000000000000000000
44P4404400044400004044040
1111111111111111111111111
2223222322232223222322232
3322222222222222222222222
2222222222222222222222222
2222222222222222222222222
3333332233333333333333333
2222223222222222222222222
2222222222222222222222222
222B222222222222222222222
22R3R22222222222232222222
222R2222222222222R2222222
2222222222222222222222222
2222222222222222222222222
3333232333333323332333233
