intro: Oops, we dropped you in a ravine.
intro: Dig the ground out from underneath them!
0000000000000000000000000
0000000000000000000000000
0000000000000000000000000
0000000000000000000000000
4444404400044400904044040
1111111144P11111111111111
2333222322232223222322232
3322222222222222222222222
2222222222222222222222222
2222222222222222222222222
3333332233333333333333333
2222223222222222222222222
2222222222222222222222222
222B2222222222222B2222222
22R3R22222222222R3R222222
222R2222222222222R2222222
2222222222222222222222222
2222222222222222222222R22
3333332333333333333333333

