intro: Genocide is okay if it makes us rich!
0000000000000000000000000
0000000000000000000000000
0000000000000000000000000
0000000000000000000000000
44444P4400044400904000000
1111111111111111111440000
2333222322223223222114000
3322222222222222222221111
2222222222222222222222222
2222222222222222222222222
333333B333333333333333333
2222223222222222222222222
2222222222222222222222222
222B2222222222222B2222222
22R3R22222222222333222222
222R2222222222222R2222222
2222222222222222222222222
2222222222222222222222R22
3333332333333333333333333


