intro: Genocide is okay if it makes us rich!
0000000000000000000000000
0000000000000000000000000
0000000000000000000000000
0000000000000000000000000
00004P4400044400904000000
0004111B21111111111440000
4441R22322222222222114000
1113222222222222222221111
2222222222222222222222222
22222222222R2B22222222222
333333B223B3R3R3333333333
2222223322222222222222222
2222222222222222222222222
222B2222222222222B2222222
22R3R22222222222333222222
222R2222222222222R2222222
2222222222222222222222222
2222222222222222222222R22
3333333333333333333333233
